11
111111111111111
111111111111111
111111111111111
111111111111111
111111111111111
111111111111110
111111111111110
111111111100000
011111111000000
010111111000000
000111111000000
000111100000000
000111100000000
000000000000000
000000000000000
000000000000000
000000000000000
000000000000111
000000000000111
000000000000111
11