0000
222222211122222
200000222220002
200000000000002
200000000000022
200222222220021
200211111120021
200222222220021
200000000000021
200000000222022
222220000212002
111120000212002
222120000212002
202220002212002
200000022122022
202220221220021
222120212200022
111120222000002
222220000000002
200000222000002
222222212222222