0000
000100001111111
000000010000000
000000000000000
000000000000000
100000000000000
000010000000000
000000000000000
100000000111111
100000000000000
100000000000000
000000000000111
000000010000001
000000010000000
000000010000000
000000010000000
000100011000000
111100000100000
000000000000000
000000000000000
000000010000000