000000000011000
000000000011000
000000000011000
000000000000000
000010000000000
000111100000000
000000000000111
000000000000000
000000000000000
100000000000000
100000000001000
111100000001000
000000000000000
000000000100000
000000000100000
000100000000000
000100000000000
000000000000000
000000011000000
000000011000000