000000000000000
000000010000000
000000100000000
000001000000000
000010000000000
000000000000000
000000000111111
000000000000000
100000000000000
100000000000000
100000010000000
000000010000111
000000010000000
000000010000000
000000010000000
000100011100000
111100000000000
000000000000000
000000000000000
000000010000000